id,affirm_time,select_hero_count,select_hero_time
"800001","0","0","0"
"800002","0","0","0"
"810000","60","2","60"
"810001","60","1","30"
"810002","60","0","30"
"812000","60","0","30"
"812001","60","0","30"
"812002","60","1","30"
"813001","60","2","60"
"813002","60","2","60"
"813003","60","0","30"
"815000","60","2","60"
"815001","60","1","30"
"815002","60","2","60"
"817001","60","2","60"
"817002","60","1","30"
"817003","60","0","30"
"910001","60","2","60"
